111111111111111111111
1010P0101110111010111
101010111111111111101
10F000000000000000111
101110101111101011101
111111101110101000101
100011101111101011101
101010101111111010101
111011101000101011101
1000C00C10101F0000001
111111111111111111111